1 7 608 768 1088 768 1088 992 992 992 992 1248 1248 1248 1248 1152 
1 36 1248 1088 1248 992 1152 992 1152 768 1728 768 1728 960 1920 1152 2112 1152 2112 1280 1760 1632 1536 1632 1536 1440 1120 1440 1120 1408 1568 1408 1568 1600 1760 1600 2080 1280 2080 1184 1920 1184 1760 1024 1760 1472 1696 1536 1632 1536 1632 1344 960 1344 960 1408 1056 1408 1056 1440 960 1440 960 1504 1472 1504 1472 1696 1664 1696 1664 1856 1600 1856 
1 4 2176 1152 2368 1152 2560 960 2560 768 
-2 14 608 768 608 928 96 928 96 608 160 608 160 576 96 576 96 192 576 192 576 576 512 576 512 608 608 608 608 704 
-1 7 608 704 1728 704 1728 512 1920 320 2368 320 2560 512 2560 704 
-4 8 1248 1088 1280 1088 1280 992 1408 992 1408 1248 1280 1248 1280 1152 1248 1152 
-3 15 2176 1152 2176 1344 1824 1696 1728 1696 1728 1920 1376 1920 1376 1600 640 1600 640 1632 1344 1632 1344 1920 1280 1920 1280 1696 576 1696 576 1504 
-1 8 640 1536 864 1536 864 1344 928 1344 928 1536 1440 1536 1440 1856 1504 1856 
3 2 640 1536 640 1504 
3 6 640 1504 832 1504 832 1056 352 1056 352 1504 576 1504 
-4 8 1504 1856 1504 1824 1472 1824 1472 1728 1632 1728 1632 1824 1600 1824 1600 1856 
-2 3 2560 704 2784 704 2784 1280 
2 3 2560 768 2720 768 2720 1280 
3 5 2720 1280 2592 1280 2592 1568 2720 1568 2720 1600 
-3 5 2784 1280 2912 1280 2912 1568 2784 1568 2784 1600 
4 4 2720 1600 2592 1600 2592 1664 2560 1664 
4 5 2560 1728 2592 1728 2592 1888 2720 1888 2720 1920 
-4 5 2784 1600 2912 1600 2912 1888 2784 1888 2784 1920 
1 9 2560 1664 2560 1472 2208 1472 1856 1824 1856 1920 2464 1920 2464 1888 2560 1888 2560 1728 
-1 5 2784 1920 3008 1920 3008 2304 2496 2816 2496 2592 
-1 3 2496 2400 2496 1920 2720 1920 
5 8 2496 2400 2464 2400 2464 1952 352 1952 352 2816 2464 2816 2464 2592 2496 2592 
2 5 448 608 224 608 224 576 352 576 352 320 
-2 5 448 608 448 576 384 576 384 320 352 320 
